from title import FadeTile; <out> = FadeTile(<raw>,Tile.AUTO,Tile.AUTO,fade_start=3.0,fade_time=1.0,halo_img=None,collision=Entity.ENTER,rsize=6)
                                                                                                                  
        _______ .______    __       _______.  ______    _______   _______     __                .______    __        ______   ____    __    ____     _______ .___  ___.     __    __  .______   
       |   ____||   _  \  |  |     /       | /  __  \  |       \ |   ____|   |  |               |   _  \  |  |      /  __  \  \   \  /  \  /   /    |   ____||   \/   |    |  |  |  | |   _  \  
       |  |__   |  |_)  | |  |    |   (----`|  |  |  | |  .--.  ||  |__      |  |     ______    |  |_)  | |  |     |  |  |  |  \   \/    \/   /     |  |__   |  \  /  |    |  |  |  | |  |_)  | 
       |   __|  |   ___/  |  |     \   \    |  |  |  | |  |  |  ||   __|     |  |    |______|   |   _  <  |  |     |  |  |  |   \            /      |   __|  |  |\/|  |    |  |  |  | |   ___/  
       |  |____ |  |      |  | .----)   |   |  `--'  | |  '--'  ||  |____    |  |               |  |_)  | |  `----.|  `--'  |    \    /\    /       |  |____ |  |  |  |    |  `--'  | |  |      
       |_______|| _|      |__| |_______/     \______/  |_______/ |_______|   |__|               |______/  |_______| \______/      \__/  \__/        |_______||__|  |__|     \______/  | _|      
                                                                                                                                                                                                
