<out> = Level(<level>,<game>,<raw>,autoscroll_speed=(0.25, 0),name=_('YIANG for Dummies'),color=[25, 0, 0],postfx=[('ingame1.sfx', ())],vis_ofs=4,scroll=3,lower_offset=0.0)




.  .  .  .  _A1_A0_A0_A0_A0_A0_A0_A0_A0_A0_A0_A0_A0_A0_A0_A0_A0_A0_A0_A0_A0_A0_A0_A0_A0_A0_A0_A0_A0_A0_A0_A0_A0_A0_A0_A0_A0_A0_A0_A0_A0_A0_A0_A0_A0_A0_A0_A0_A0_A0_A0_A0_A0_A0_A0_A0_A0_A0_A0_A0_A0_A0_A0_A0_A0_A0_A0_A0_A0_A0_A0_A0_A0_A0_A0_A0_A0_A0_A0_A0_A0_A0_A0_A0_A0_A0_A0_A0_A0_A0_A0_A0_A0_A0_A0_A0_A0_A0_A0_A0_A0_A0_A0_A0_A0_A0_A0_A0_A0_A0_A0_A0_A0_A0_A0_A0_A0_A0_A0_A0_A0_A0_A0_A0_A0_A0_A0_A0_A0_A0_A0_A0_A0_A0_A0_A0_A0_A0_A0_A0_A0_A0_A2
.  .  .  _A1_B6_B6_B6_B6_B6_B6_B6_B6_B6_B6_B6_B6_B6_B6_B6_B6_B6_B6_B6_B6_B6_B6_B6_B6_B6_B6_B6_B6_B6_B6_B6_B6_B6_B6_B6_B6_B6_B6_B6_B6_B6_B6_B6_B6_B6_B6_B6_B6_B6_B6_B6_B6_B6_B6_B6_B6_B6_B6_B6_B6_B6_B6_B6_B6_B6_B6_B6_B6_B6_B6_B6_B6_B6_B6_B6_B6_B6_B6_B6_B6_B6_B6_B6_B6_B6_B6_B6_B6_B6_B6_B6_B6_B6_B6_B6_B6_B6_B6_B6_B6_B6_B6_B6_B6_B6_B6_B6_B6_B6_B6_B6_B6_B6_B6_B6_B6_B6_B6_B6_B6_B6_B6_B6_B6_B6_B6_B6_B6_B6_B6_B6_B6_B6_B6_B6_B6_B6_B6_B6_B6_B6_B6_B6_A2
.  .  _A1_B6_B6_B6_B6_B6_B6_B6_B6_B6_B6_B6_B6_B6_B6_B6_B6_B6_B6_B6_B6_B6_B6_B6_B6_B6_B6_B6_B6_B6_B6_B6_B6_B6_B6_B6_B6_B6_B6_B6_A1_A3_A3_A3_A3_A3_A2_B6_B6_B6_B6_B6_B6_B6_B6_B6_B6_B6_B6_B6_B6_B6_B6_B6_B6_B6_B6_B6_B6_B6_A1_A3_A3_A3_A3_A3_A2_B6_B6_B6_B6_B6_B6_B6_B6_B6_B6_B6_B6_B6_B6_B6_B6_B6_B6_B6_B6_B6_B6_B6_B6_B6_B6_B6_B6_B6_B6_B6_B6_A1_A3_A3_A3_A3_A3_A2_B6_B6_B6_B6_B6_B6_B6_B6_B6_B6_B6_B6_B6_B6_B6_B6_B6_B6_B6_B6_B6_B6_B6_B6_B6_B6_B6_B6_B6_B6_A2
.  _A1_B6_B6_B6_B6_B6_B6_B6_B6_B6_B6_B6_B6_B6_B6_B6_B6_B6_B6_B6_B6_B6_B6_B6_B6_B6_B6_B6_B6_B6_B6_B6_B6_B6_B6_B6_B6_B6_B6_B6_A1_B6_B6_B6_B6_B6_B6_B6_A2_B6_B6_B6_B6_B6_B6_B6_B6_B6_B6_B6_B6_B6_B6_B6_B6_B6_B6_B6_B6_B6_A1_B6_B6_B6_B6_B6_B6_B6_A2_B6_B6_B6_B6_B6_B6_B6_B6_B6_B6_B6_B6_B6_B6_B6_B6_B6_B6_B6_B6_B6_B6_B6_B6_B6_B6_B6_B6_B6_B6_A1_B6_B6_B6_B6_B6_B6_B6_A2_B6_B6_B6_B6_B6_B6_B6_B6_B6_B6_B6_B6_B6_B6_B6_B6_B6_B6_B6_B6_B6_B6_B6_B6_B6_B6_B6_B6_B6_B6_A2
_A1_B6_B6_B6_B6_B6_B6_B6_B6_B6_B6_B6_B6_B6_B6_B6_B6_B6_B6_B6_B6_B6_B6_B6_B6_B6_B6_B6_B6_B6_B6_B6_B6_B6_B6_B6_B6_B6_B6_B6_A1_B6_B6_A8_B6_B6_B6_A8_B6_B6_A2_B6_B6_B6_B6_B6_B6_B6_B6_B6_B6_B6_B6_B6_B6_B6_B6_B6_B6_B6_A1_B6_B6_A8_B6_B6_B6_A8_B6_B6_A2_B6_B6_B6_B6_B6_B6_B6_B6_B6_B6_B6_B6_B6_B6_B6_B6_B6_B6_B6_B6_B6_B6_B6_B6_B6_B6_B6_B6_A1_B6_B6_A8_B6_B6_B6_A8_B6_B6_A2_B6_B6_B6_B6_B6_B6_B6_B6_B6_B6_B6_B6_B6_B6_B6_B6_B6_B6_B6_B6_B6_B6_B6_B6_B6_B6_B6_B6_B6_B6_A2
_A9yKE.  .  .  .  .  .  .  .  .  .  .  .  .  _A9.  .  .  .  .  .  .  .  .  .  .  .  .  .  .  .  .  .  .  .  .  .  .  .  .  .  .  .  .  .  .  .  .  .  .  .  .  .  .  .  .  .  BTC.  .  .  .  .  .  .  .  .  .  .  .  .  .  .  .  .  .  .  .  .  .  .  .  .  .  .  .  .  .  .  .  .  .  .  .  .  .  .  .  .  .  .  .  .  .  .  .  .  .  .  .  .  .  .  .  .  .  .  .  .  .  .  .  .  .  .  .  .  .  .  .  .  .  .  .  .  .  .  .  .  .  _A9.  .  .  .  .  .  .  .  _A9
_A9.  .  .  .  .  .  .  .  .  .  .  .  yTB.  _A9.  .  .  .  .  .  .  .  .  .  .  .  .  .  .  .  .  .  .  .  _i3.  .  .  .  .  .  .  .  .  .  .  .  .  .  .  .  .  .  .  .  .  .  _i4yDO.  _i5.  .  .  .  .  .  .  .  .  .  .  .  .  rRD.  .  .  .  .  .  .  .  .  .  .  .  .  .  .  .  .  .  .  .  .  .  .  .  .  .  .  .  .  .  .  .  .  .  .  .  .  .  .  .  .  .  .  .  .  .  .  .  .  .  .  .  .  .  .  .  .  .  .  .  .  .  .  .  _A9.  yFI.  .  .  .  .  .  _A9
_A9.  .  .  .  .  .  .  .  .  .  .  yRDyPL.  _A9.  .  .  .  .  .  .  .  .  .  .  .  .  .  .  .  .  .  .  .  .  .  .  .  .  .  .  .  .  .  .  .  .  .  .  .  .  .  .  .  .  .  .  .  .  .  .  _C9.  .  .  .  .  .  .  .  .  .  .  .  .  _i6.  _CC.  .  .  .  .  .  .  .  .  .  .  .  .  .  .  .  .  .  .  .  .  .  .  .  .  .  .  .  .  .  .  .  .  .  .  .  .  .  rDK.  .  .  .  .  .  .  .  .  .  .  .  .  .  .  .  .  .  .  .  .  .  _A9.  .  .  .  .  .  .  .  _A9
_A9.  .  .  .  .  .  .  .  .  .  .  .  _i0.  _A9.  .  .  .  .  .  .  .  .  .  .  .  .  .  _A0_A0_A0_A0_A0_A0_A0_A0_A0_A0_A0_A0_A0_A0_A0_A0_A0_A0_A0_A0_A0_A0_A0_A0_A0_A0_A0_A0_A0_A0_A0_A0_A0_A0_A0_A0_C8.  .  .  _A0_A0_A0_A0_A0_A0_A0_A0_A0_A0.  .  .  .  .  .  .  .  .  .  .  .  .  .  .  .  .  .  .  .  .  .  .  .  .  .  .  .  .  .  .  .  .  .  .  .  .  .  .  .  .  .  .  .  .  .  .  .  .  .  .  .  .  .  .  .  .  .  .  .  .  _A9rDE.  .  .  .  .  .  .  _A9
_A9.  .  .  _A0_A0_A0_A0_A0_A0_A0_A0_A0_A0_A0_A0.  .  .  .  .  .  .  .  .  .  .  .  .  .  _B6.  .  .  .  .  .  .  .  .  .  .  .  .  .  .  .  .  .  .  _B6.  .  .  .  .  .  .  .  .  _B6.  .  .  .  _B6.  .  .  .  _B6.  .  .  .  .  .  .  .  .  .  .  .  .  .  dAMdAMdAM.  .  .  .  .  .  .  .  .  .  .  .  .  .  .  .  .  .  .  .  .  .  .  .  .  .  .  .  .  .  .  .  .  .  .  .  .  .  .  .  .  .  .  .  .  .  .  .  .  .  .  .  .  _A0_A0_A0_A0_A0.  .  .  .  _A9
_A9.  .  .  .  .  .  .  .  .  .  .  .  .  .  .  .  .  .  .  .  .  .  .  .  .  .  .  .  .  _B6.  .  .  .  .  .  .  .  .  .  .  .  .  .  .  .  .  .  .  _B6.  .  .  .  .  .  .  .  .  _B6.  .  .  .  _B6.  .  .  .  _B6rE2.  rE2.  rE2.  rE2.  .  .  .  .  dW0.  dAMdAMdAM.  .  .  .  .  .  .  .  .  .  .  .  .  .  .  .  .  .  .  .  .  .  .  .  .  .  .  .  .  .  .  .  .  .  .  .  .  .  .  .  .  .  .  .  .  .  .  .  .  .  .  .  .  .  .  .  .  rDA.  .  .  .  _A9
_A9.  .  .  .  .  .  .  .  .  .  .  .  .  .  .  .  .  .  .  .  .  .  .  .  .  .  .  .  .  _B6.  .  .  .  .  .  .  .  .  .  .  .  .  .  .  .  .  .  .  _B6.  .  .  .  .  .  .  .  .  _B6.  .  .  .  _B6.  .  .  .  _B6.  .  .  .  .  .  .  .  _B6.  .  .  .  .  dAMdAMdAM.  .  .  .  .  .  .  .  .  .  .  .  .  .  .  .  .  .  .  .  .  .  rD3.  .  .  .  .  .  .  .  .  .  .  .  .  .  .  .  .  rDE.  .  .  .  .  .  .  .  .  .  .  .  .  .  .  .  rDA.  .  .  .  _A9
_A9.  .  .  .  .  .  .  .  .  .  .  .  .  .  .  .  .  .  .  .  .  .  .  .  .  .  .  .  .  _B6.  .  .  .  .  .  .  .  .  .  .  .  .  _E8.  .  .  .  .  _B6.  .  .  .  .  .  .  .  .  _B6.  .  .  .  _B6.  .  .  rDE_B6_A0_A0_A0_A0_A0_A0_A0_A0_A0_A0_A0_A0_A0_A0_A0_A0_A0_A0_A0_A0_A0_A0_A0_A0_A0_A0_A0_A0_A0_A0.  .  .  .  .  .  .  .  .  .  .  .  .  .  .  rDE.  .  .  .  .  .  .  .  .  .  .  .  .  .  .  .  .  .  .  rRD.  .  .  .  .  .  .  .  rTR.  .  .  .  _A9
_A9.  .  .  .  .  .  .  .  .  .  .  .  .  .  .  .  .  .  .  .  _D4.  .  .  .  .  _CE.  .  _B6.  .  .  .  .  .  .  _E9.  .  .  .  .  .  .  _E3.  .  .  _B6.  .  .  .  _EC.  .  .  .  _B6.  .  .  .  _B6.  .  .  .  _B6.  .  .  .  .  .  .  .  .  .  .  .  .  .  .  .  .  .  .  .  .  .  .  dAMdAMdAM.  .  .  .  .  .  .  .  .  .  .  .  .  rDO.  _CC.  .  .  .  .  .  .  .  .  .  .  .  .  .  .  .  .  .  .  .  .  .  .  .  .  .  .  .  .  .  .  .  rTR.  .  .  .  _A9
_A9.  .  .  .  .  .  .  .  .  _i1.  .  .  yTA.  .  .  _i2.  .  .  .  .  .  .  .  .  .  .  _B6.  .  .  .  .  .  .  .  _E7.  .  .  .  .  .  .  .  .  .  _B6.  .  .  .  .  .  .  .  .  _B6.  .  .  .  _B6.  .  BTA.  _B6rKE.  rE2.  rE2.  rE2.  rE2.  rE2.  rE2.  rE2.  rE2.  .  .  .  rCC.  dAMdAMdAM.  .  .  .  .  .  .  .  .  .  .  .  _i7.  rRD_CC.  .  _i8.  .  .  .  .  .  .  .  .  .  rCC.  .  .  .  .  .  .  .  .  rRD.  .  .  .  .  _i9.  .  rTRpMJ.  .  .  _A9
_A9.  .  .  .  .  .  .  .  .  .  .  .  .  .  .  .  .  .  .  .  .  .  .  .  .  .  .  .  .  _B6.  _E0.  .  .  _E5.  .  .  .  .  .  .  .  .  .  .  .  .  _B6.  .  .  .  .  .  .  .  .  _B6.  .  .  .  _B6.  .  .  .  _B6.  .  .  .  .  .  .  .  .  .  .  .  .  .  .  .  .  .  _B6.  .  .  .  dAMdAMdAM.  .  .  .  .  .  _A0.  .  .  .  .  .  .  .  .  .  .  .  _A0rDArDArDArDA_A0.  .  .  .  .  rDArDArDArDArDArDArDArDA.  .  .  .  .  .  .  .  .  .  rTR.  .  .  .  _A9
_A0_A0_A6_A6_A0_A0_A0_A6_A6_A0_A0_A0_A6_A6_A0_A0_A0_A6_A6_A0_A0_A0_A6_A6_A0_A0_A0_A6_A6_A0_A0_A0_A6_A6_A0_A0_A0_A6_A6_A0_A0_A0_A6_A6_A0_A0_A0_A6_A6_A0_A0_A0_A6_A6_A0_A0_A0_A6_A6_A0_A0_A0_A6_A6_A0_A0_A0_A6_A6_A0_A0_A0_A6_A6_A0_A0_A0_A6_A6_A0_A0_A0_A6_A6_A0_A0_A0_A6_A6_A0_A0_A0_A6_A6_A0_A0_A0_A6_A6_A0_A0_A0_A6_A6_A0_A0_A0_A6_A6_A0_A0_A0_A6_A6_A0_A0_A0_A6_A6_A0_A0_A0_A6_A6_A0_A0_A0_A6_A6_A0_A0_A0_A6_A6_A0_A0_A0_A6_A6_A0_A0_A0_A6_A6_A0_A0_A0_A6_A6_A0_A0
_A4_AN.  .  _AO_A4_AN.  .  _AO_A4_AN.  .  _AO_A4_AN.  .  _AO_A4_AN.  .  _AO_A4_AN.  .  _AO_A4_AN.  .  _AO_A4_AN.  .  _AO_A4_AN.  .  _AO_A4_AN.  .  _AO_A4_AN.  .  _AO_A4_AN.  .  _AO_A4_AN.  .  _AO_A4_AN.  .  _AO_A4_AN.  .  _AO_A4_AN.  .  _AO_A4_AN.  .  _AO_A4_AN.  .  _AO_A4_AN.  .  _AO_A4_AN.  .  _AO_A4_AN.  .  _AO_A4_AN.  .  _AO_A4_AN.  .  _AO_A4_AN.  .  _AO_A4_AN.  .  _AO_A4_AN.  .  _AO_A4_AN.  .  _AO_A4_AN.  .  _AO_A4_AN.  .  _AO_A4_AN.  .  _AO_A4
_AO.  .  .  .  _AO.  .  .  .  _AO.  .  .  .  _AO.  .  .  .  _AO.  .  .  .  _AO.  .  .  .  _AO.  .  .  .  _AO.  .  .  .  _AO.  .  .  .  _AO.  .  .  .  _AO.  .  .  .  _AO.  .  .  .  _AO.  .  .  .  _AO.  .  .  .  _AO.  .  .  .  _AO.  .  .  .  _AO.  .  .  .  _AO.  .  .  .  _AO.  .  .  .  _AO.  .  .  .  _AO.  .  .  .  _AO.  .  .  .  _AO.  .  .  .  _AO.  .  .  .  _AO.  .  .  .  _AO.  .  .  .  _AO.  .  .  .  _AO.  .  .  .  _AO.  .  .  .  _AO.  .  .  .  _AO
_B6.  .  .  .  _B6.  .  .  .  _B6.  .  .  .  _B6.  .  .  .  _B6.  .  .  .  _B6.  .  .  .  _B6.  .  .  .  _B6.  .  .  .  _B6.  .  .  .  _B6.  .  .  .  _B6.  .  .  .  _B6.  .  .  .  _B6.  .  .  .  _B6.  .  .  .  _B6.  .  .  .  _B6.  .  .  .  _B6.  .  .  .  _B6.  .  .  .  _B6.  .  .  .  _B6.  .  .  .  _B6.  .  .  .  _B6.  .  .  .  _B6.  .  .  .  _B6.  .  .  .  _B6.  .  .  .  _B6.  .  .  .  _B6.  .  .  .  _B6.  .  .  .  _B6.  .  .  .  _B6.  .  .  .  _B6
_B6.  .  .  .  _B6.  .  .  .  _B6.  .  .  .  _B6.  .  .  .  _B6.  .  .  .  _B6.  .  .  .  _B6.  .  .  .  _B6.  .  .  .  _B6.  .  .  .  _B6.  .  .  .  _B6.  .  .  .  _B6.  .  .  .  _B6.  .  .  .  _B6.  .  .  .  _B6.  .  .  .  _B6.  .  .  .  _B6.  .  .  .  _B6.  .  .  .  _B6.  .  .  .  _B6.  .  .  .  _B6.  .  .  .  _B6.  .  .  .  _B6.  .  .  .  _B6.  .  .  .  _B6.  .  .  .  _B6.  .  .  .  _B6.  .  .  .  _B6.  .  .  .  _B6.  .  .  .  _B6.  .  .  .  _B6
_B6.  .  .  .  _B6.  .  .  .  _B6.  .  .  .  _B6.  .  .  .  _B6.  .  .  .  _B6.  .  .  .  _B6.  .  .  .  _B6.  .  .  .  _B6.  .  .  .  _B6.  .  .  .  _B6.  .  .  .  _B6.  .  .  .  _B6.  .  .  .  _B6.  .  .  .  _B6.  .  .  .  _B6.  .  .  .  _B6.  .  .  .  _B6.  .  .  .  _B6.  .  .  .  _B6.  .  .  .  _B6.  .  .  .  _B6.  .  .  .  _B6.  .  .  .  _B6.  .  .  .  _B6.  .  .  .  _B6.  .  .  .  _B6.  .  .  .  _B6.  .  .  .  _B6.  .  .  .  _B6.  .  .  .  _B6



