<out> = Level(<level>,<game>,<raw>,color=(20,0,0),vis_ofs=2,name="Jumper")
.  .  .  .  .  .  .  .  gS3.  .  .  .  .  .  .  .  .  .  .  .  .  .  .  .  .  .  .  .  .  .  .  .  .  .  .  .  .  .  .  .  .  .  .  .  .  .  .  .  .  .  .  .  .  .  .  .  .  
.  .  .  .  .  .  .  gS1.  .  .  .  .  .  .  gS1.  .  .  .  .  .  .  .  .  gS1.  .  .  .  .  .  .  .  .  .  .  .  .  .  .  .  .  .  .  .  .  .  .  .  .  .  .  .  .  .  .  .  
.  .  .  .  .  .  .  ~TB.  .  .  .  .  .  .  _TB.  .  .  .  .  .  .  .  .  ~TB.  .  .  .  .  .  .  .  .  .  .  .  .  .  .  rA8.  .  .  .  rTB.  yTB.  .  .  .  .  .  .  .  .  
.  .  .  dTB.  .  .  .  .  .  .  .  .  .  .  .  .  .  .  .  .  .  .  .  .  .  .  .  .  .  .  .  .  .  .  .  .  .  .  .  .  _AA.  .  .  .  .  .  .  .  .  .  .  .  .  .  .  .  
.  .  .  .  .  .  .  .  .  .  .  .  .  .  .  .  .  .  .  .  .  .  .  .  .  .  _i1.  .  .  .  .  .  .  .  .  .  .  .  .  .  _AAbTC.  .  .  .  .  .  .  .  .  .  .  .  .  .  .  
.  .  .  .  .  .  .  .  .  .  .  .  .  .  .  .  .  .  .  .  .  .  .  .  .  .  .  .  .  .  .  .  .  .  .  .  .  .  .  .  .  _AA.  .  .  .  .  .  .  .  .  .  .  .  .  .  .  .  
.  .  .  .  .  .  .  .  .  .  .  .  .  .  .  .  .  .  .  .  .  .  .  .  .  .  .  .  .  .  .  .  .  .  .  .  .  .  .  .  .  _AA.  .  .  .  .  .  .  .  .  .  .  .  .  .  .  .  
.  .  .  rPL.  .  .  .  .  .  .  .  .  .  .  .  .  .  .  .  .  .  .  .  .  .  .  .  .  .  .  .  .  .  .  .  .  rA8.  .  .  _AA.  .  .  .  .  .  .  .  .  .  .  .  .  .  .  .  
.  .  .  .  .  .  .  .  .  .  .  .  .  .  .  .  .  .  .  .  .  .  .  .  .  .  .  .  .  .  .  .  .  .  .  .  .  _AA.  gS3.  _AA.  .  .  .  .  .  .  .  .  .  .  .  .  .  .  .  
.  .  _A9_A9.  .  .  .  rKE.  .  .  .  .  .  .  gKE.  .  .  .  .  .  .  .  _AA.  .  .  .  .  .  .  .  .  .  .  _AAgS3gS3.  _AA.  .  .  .  .  .  .  .  .  .  .  _AA_AA_AA_AA_AA
.  .  .  .  .  .  .  .  .  .  .  .  .  .  .  .  .  .  .  .  .  .  .  .  .  _AA.  .  .  .  .  .  .  .  .  .  .  _AAgS3gS3~TA_AA.  .  .  .  .  .  .  .  .  .  .  .  .  .  .  _B0
.  .  .  .  .  .  .  .  .  .  .  .  .  .  .  .  .  .  .  .  .  .  .  .  .  _AA.  .  .  .  .  .  .  .  .  _AA.  _AA_AA_AA_AA_AA.  .  .  .  .  .  .  .  .  .  .  .  .  .  .  _B0
.  .  .  .  .  .  .  .  .  .  .  .  .  .  .  .  .  .  .  .  .  .  .  .  .  _AA.  .  .  .  .  .  .  _AA.  _AA.  _AA.  .  .  _AA.  .  .  .  .  .  .  .  .  .  .  .  .  .  .  _B0
.  .  .  .  .  .  .  .  .  .  .  .  .  .  .  .  .  yKE.  .  .  .  .  .  .  _AA.  .  .  .  .  _AA.  _AA.  _AA.  _AA.  .  .  _AA.  .  .  .  .  .  .  .  .  .  .  .  .  .  .  _B0
.  .  .  .  .  .  .  .  .  .  .  .  .  .  .  .  .  .  .  .  .  .  .  .  .  _AA.  .  .  .  .  _AA_AA_AA_AA_AA_AA_AA.  .  .  _AA.  .  .  .  .  .  .  .  .  .  .  .  .  .  .  _B0
.  .  .  bKE.  .  .  .  .  .  .  .  .  .  .  .  .  .  .  .  .  .  .  .  .  _AA.  .  .  .  .  _AA_AA_AA_AA_AA_AA_AA.  .  .  _AA.  .  .  .  .  .  .  .  .  .  .  .  .  .  .  _B0
.  .  .  .  .  .  .  .  .  .  .  .  .  .  .  .  .  .  .  .  .  .  .  .  .  _AA.  .  dTA.  .  rDO.  gDO.  bDO.  yDO.  .  .  .  .  .  rTA.  yTA.  bTA.  .  .  .  .  .  .  .  _B0
.  .  .  ~TA.  .  .  .  _TA.  .  .  .  .  .  .  .  ~TA.  .  .  .  .  .  .  _AA.  .  .  .  .  .  .  .  .  .  .  .  .  .  .  .  .  .  .  .  .  .  .  .  .  .  .  .  .  .  .  _B0
.  .  gS1gS1gS1.  .  gS1gS1gS1.  .  .  .  .  .  gS1gS1gS1.  .  .  .  .  .  _AA_AA_AA_AA_AA_AA_AA_AA_AA_AA_AA_AA_AA_AA_AA_AA_AA_AA_AA_AA_AA_AA_AA_AA_AA_AA_AA_AA_AA_AA_AA_AA_AA
.  .  .  .  .  .  .  .  .  .  .  .  .  .  .  .  .  .  .  .  .  .  .  .  .  .  .  .  .  .  .  .  .  .  .  .  .  .  .  .  .  .  .  .  .  .  .  .  .  .  .  .  .  .  .  .  .  .  
_IN_IN_IN_IN_IN_IN_IN_IN_IN_IN_IN_IN_IN_IN_IN_IN_IN_IN_IN_IN.  .  .  .  .  .  .  .  .  .  .  .  .  .  .  .  .  .  .  .  .  .  .  .  .  .  .  .  .  .  .  .  .  .  .  .  .  .  
.  .  .  .  .  .  .  .  .  .  .  .  .  .  .  .  .  .  .  .  .  .  .  .  .  .  .  .  .  .  .  .  .  .  .  .  .  .  .  .  .  .  .  .  .  .  .  .  .  .  .  .  .  .  .  .  .  .  
.  .  .  .  .  .  .  .  .  .  .  .  .  .  .  .  .  .  .  .  .  .  .  .  .  .  .  .  .  .  .  .  .  .  .  .  .  .  .  .  .  .  .  .  .  .  .  .  .  .  .  .  .  .  .  .  .  .  