<out> = Level(<level>,<game>,<raw>,autoscroll_speed=(-0.0, 0),name=_('Dungeon without Dragons'),color=(0, 0, 0),postfx=[('ingame1.sfx', ())],vis_ofs=4,bgimg=2,scroll=3,lower_offset=0.0)
_A6_A6_A6_A6_A6_A6_A6_A6_A6_A6_A6_A6_A6_A6_A6_A6_A6_A6_A6_A6_A6_A6_A6_A6_A6_A6_A6_A6_A6_A6_A6_A6_A6_A6_A6_A6_A6_A6_A6_A6_A6_A6_A6_A6_A6_A6_A6_A6_A6_A6_A6_A6_A6_A6_A6_A6_A6_A6_A6_A6_A6_A6_A6_A6_A6_A6_A6_A6_A6_A6_A6_A6_A6_A6_A6_A6_A6_A6_A6_A6_A6_A6_A6_A6_A6_A6_A6_A6_A6_A6
_A6_A6_A6_A6_A6_A6_A6_A6_A6_A6_A6_A6_A6_A6_A6_A6_A6_A6_A6_A6_A6_A6_A6_A6_A6_A6_A6_A6_A6_A6_A6_A6_A6_A6_A6_A6_A6_A6_A6_A6_A6_A6_A6_A6_A6_A6_A6_A6_A6_A6_A6_A6_A6_A6_A6_A6_A6_A6_A6_A6_A6_A6_A6_A6_A6_A6_A6_A6_A6_A6_A6_A6_A6_A6_A6_A6_A6_A6_A6_A6_A6_A6_A6_A6_A6_A6_A6_A6_A6_A6
_A6_A6_A6_A6_A6_A6_A6_A6_A6_A6_A6_A6_A6_A6_A6_A6_A6_A6_A6_A6_A6_A6_A6_A6_A6_A6_A6_A6_A6_A6_A6_A6_A6_A6_A6_A6_A6_A6_A6_A6_A6_A6_A6_A6_A6_A6_A6_A6_A6_A6_A6_A6_A6_A6_A6_A6_A6_A6_A6_A6_A6_A6_A6_A6_A6_A6_A6_A6_A6_A6_A6_A6_A6_A6_A6_A6_A6_A6_A6_A6_A6_A6_A6_A6_A6_A6_A6_A6_A6_A6
_A6_A6_A6_A6_A6_A6_A6_A6_A6_A6_A6_A6_A6_A6_A6_A6_A6_A6_A6_A6_A6_A6_A6_A6_A6_A6_A6_A6_A6_A6_A6_A6_A6_A6_A6_A6_A6_A6_A6_A6_A6_A6_A6_A6_A6_A6_A6_A6_A6_A6_A6_A6_A6_A6_A6_A6_A6_A6_A6_A6_A6_A6_A6_A6_A6_A6_A6_A6_A6_A6_A6_A6_A6_A6_A6_A6_A6_A6_A6_A6_A6_A6_A6_A6_A6_A6_A6_A6_A6_A6_A6_A6_A6_A6_A6_A6_A6_A6_A6_A6_A6_A6_A6_A6_A6_A6_A6_A6_A6
_A6_A6_A6pKE.  .  .  .  .  .  .  .  .  .  .  .  .  .  .  .  .  .  .  .  .  .  .  .  .  .  .  .  rC5rC5.  .  rC5rC5.  .  .  .  .  .  .  .  .  .  .  .  .  .  .  .  .  .  .  _S0_S0_S0_S0_S0_S0_S0_S0_S0_S0_S0_S0_A6rE1.  .  .  .  .  .  .  .  .  .  .  .  .  .  _A6.  .  .  .  .  .  .  .  .  .  .  .  .  .  .  .  .  .  .  .  .  .  _A6
_A6_A6_A6.  .  .  .  .  .  .  .  .  .  .  .  .  .  .  .  .  .  .  .  .  .  .  .  .  .  .  .  .  .  .  .  .  .  .  .  .  .  .  .  .  .  .  .  .  .  .  .  .  .  .  .  .  .  _S0_S0_S0_S0_S0_S0_S0_S0_S0_S0_S0_S0_A6.  .  .  .  .  .  .  .  .  .  .  .  .  .  .  .  _A2.  .  .  .  .  .  .  .  .  .  .  .  .  .  .  .  .  .  .  .  .  _A6
_A6_A6_A6_A6_A6_A6_A6_A6_A6_A6_A6_A6_A6_A6_A6_A2.  .  .  .  .  .  .  .  _A1_A6_A6_A6_A6.  .  .  .  .  .  .  .  .  .  .  .  .  .  .  .  .  .  .  .  .  .  .  .  .  .  _A6_A6_S0_S0_S0_S0_S0_S0_S0_S0_S0_S0_S0_S0_A6.  .  .  .  .  .  .  .  .  .  .  .  .  .  .  .  rE1_A2.  .  .  .  .  .  .  .  .  .  .  .  .  .  .  .  .  .  .  .  _A6
_A6_A6_A6.  .  .  .  pDOyDOdDO.  .  .  .  .  _A6rE1.  .  bE2bE2.  .  rE1_A6.  .  .  _AC_A6bE2.  .  .  .  .  .  .  bE2.  .  .  .  .  .  .  .  .  _A1rE2bE2_A6_A6bE2rE2_A6rE1_S0_S0_S0_S0_S0_S0_S0_S0_S0_S0_S0_S0_A6.  .  .  .  .  .  .  .  .  .  .  .  .  .  .  .  .  .  _A2.  _S5_S5rAFrAFrAFrAFrAFrAFrAFrAFrAFrAF_A1.  .  .  .  .  _A6
_A6_A6_A6.  .  .  .  .  .  .  .  .  .  .  .  _A6_A6_A6_A6_A6_A6_A6_A6_A6_A6.  .  .  .  _AC_A6.  .  .  rE1.  .  .  _A6.  .  .  .  .  .  .  .  .  _A6_A6_A6_A6_A6_A6_A6_A6_A6_A6_A6_A6_A6_A6_A6_A6_A6_A6_A6_A6_A6_A6rE1.  .  .  .  rD9.  .  .  .  .  .  .  .  .  .  .  .  _A6_A6_A6_A6_A6_A6_A6_A6_A6_A6_A6_A5_A5_A5_A5_A5_A2.  .  .  _A6
_A6_A6_A6.  .  _A1_A6_A6_A6_A6_A6_A2.  .  .  .  .  .  .  .  .  .  .  .  .  .  .  .  .  .  _AC_A6_A6_A6_A6_A6_A6_A6_A6_A6_A6_A6_A6_A2.  .  .  .  .  .  .  .  .  _RD.  .  .  .  .  .  .  .  .  .  .  .  .  .  .  .  .  .  _A6_A6_A6_A6_A6_A6_A6_A6_A6_A6_A6_A6_A2.  .  .  .  .  .  .  .  .  .  .  .  .  .  _H1.  .  .  .  .  .  .  .  _A6
_A6_A6_A6.  .  _A6.  .  .  .  .  _AC_A2.  .  .  .  .  .  .  .  .  .  .  .  .  .  .  .  .  .  _RD.  .  .  .  .  .  .  .  .  .  .  .  .  .  .  .  .  .  .  .  .  .  .  .  .  .  .  .  .  .  .  .  .  .  .  .  .  .  .  .  _A6.  .  .  .  .  .  .  .  .  .  .  .  _A2.  .  .  .  .  .  .  .  .  _RD.  .  .  .  .  .  .  .  .  .  .  .  _A6
_A6_A6_A6.  .  _A6_S2_S2_S2.  .  .  _AC_A2.  .  .  .  .  .  .  .  .  .  .  .  .  .  .  .  .  .  .  .  .  .  .  .  .  .  .  .  .  .  .  .  .  _A1_A6_A6_A6_A6_A6_A2.  .  .  .  .  .  .  .  .  .  .  .  .  .  .  _CD.  .  _A6.  .  .  .  .  .  .  .  .  .  .  .  _AC_A2.  .  .  .  .  .  .  .  .  .  .  .  .  .  .  .  .  .  .  .  .  _A6
_A6_A6_A6.  .  _A6_A6_A6_A6.  .  .  .  .  _A2rE1.  .  bE2.  .  bE2.  .  bE2.  .  bE2.  .  rE1_A1_A6_A6_A6_A6_A6_A6_A6_A6_A6_A6_A6_A6.  .  .  .  .  .  .  .  .  _AC_A2.  .  .  .  .  .  bE2.  .  bE2.  .  .  .  .  .  .  _A6.  .  .  .  .  .  .  .  .  .  .  .  .  _AC_A6_A6_AM_AM_AM_AM_AM_AM_A6.  .  .  .  .  .  .  .  .  .  .  .  _A6
_A6_A6_A6_FI.  _A6.  .  .  .  .  .  .  .  rE1_A6rDArDA_A6rDArDA_A6rDArDA_A6rDArDA_A6rDArDA_A1_A6.  _AM.  _AM.  _AM.  _AM.  _AM.  _A6.  .  .  .  _AM_AM_AM_AM_AM.  _AC_A2rE0.  .  .  .  _A6.  .  _A6.  .  .  .  .  .  .  _A6.  .  .  .  .  .  .  .  .  .  .  .  .  .  _AC_A6_A6_A6_A6_A6_A6_A6_A6_A6_A6_A6_A6_A6_A6_A6_A2.  .  .  .  _A6
_A6_A6_A6.  .  _A6.  .  .  .  .  .  _AC_AC_AC_AC_A6_A6_A6_A6_A6_A6_A6_A6_A6_A6_A6_A6_A6_A6_A6.  .  .  .  .  .  .  .  .  .  .  .  _A6_A6_A6_A6_A6_A6_A6_A6_A6_A6_A6_A6.  _A6_A6_A6_A6_A6.  _A6_A6.  _A6_A6_A6_A6_A6_A6_A6_A6.  .  .  .  .  .  .  _E4.  .  .  .  .  .  .  .  .  .  .  .  .  .  .  .  .  .  .  .  .  .  _A6.  .  .  .  _A6
_A6_A6_A6_A6_A6_A6.  .  .  .  .  .  _AC.  .  .  .  .  _A6bE2.  .  rE1.  .  bE2_A6.  .  .  .  .  .  .  .  .  .  .  .  .  .  .  .  .  .  .  .  .  .  .  .  .  bE2.  .  rE2.  .  bE2.  .  rE2.  .  rE2.  .  .  .  .  .  .  .  .  .  .  .  .  .  .  .  .  .  .  .  .  .  .  .  .  .  .  .  .  .  .  .  .  .  .  .  .  .  _A6.  .  .  .  _A6
_A6_A6_A6.  .  .  .  .  .  .  .  .  _AC.  .  .  .  .  .  .  .  .  .  .  .  .  .  _RD.  .  .  .  .  .  .  .  .  .  .  .  .  .  .  _SS.  .  .  .  .  .  .  .  .  .  .  .  .  .  .  .  .  .  .  .  .  .  .  .  .  .  .  .  .  .  .  .  .  .  .  .  .  .  .  .  .  .  .  .  _A1_A6_A6_A6_A6_A6_A6_A2.  .  .  .  .  .  .  _A6.  .  .  .  _A6
_A6_A6_A6.  rBM.  .  .  .  .  .  .  _AC.  .  .  .  .  .  .  .  .  .  .  .  .  .  .  .  .  .  .  .  .  .  .  .  .  .  .  .  .  .  .  .  .  .  .  .  .  .  bE2.  bE2.  .  .  bE2.  bE2.  .  .  .  .  .  .  .  .  .  .  .  .  .  .  .  .  .  .  .  .  .  .  .  .  .  .  .  _A6_AM_AM_AM_AM_AM_AM_A6.  .  .  .  rE6.  .  _A6.  .  .  .  _A6
_A6_A6_A6.  .  .  .  .  .  .  .  .  _AC.  .  .  .  .  .  .  .  .  .  .  .  .  _A1_A6_A6_A6_A6_A6_A6_A6_A6_A6_A6_A6_A6_A6_A6_A6_A6_A6_A6_A6_A6_A6_A6_A6_A6_A6_A6_A6_A6_A6_A6_A6_A6_A6_A6_A6_A6_A6_A2.  .  .  .  _A1_A6_A6_A6_A6_A6_C8.  .  .  .  .  .  .  .  .  .  .  .  _RD.  .  .  .  .  .  .  .  .  .  .  .  .  .  _A6.  .  .  .  _A6
_A6_A6_A6.  .  .  .  .  .  .  .  .  _AC.  .  .  .  .  .  .  .  .  .  .  .  .  _A6.  .  .  .  .  dKE_A6.  .  .  .  .  .  .  .  .  .  .  .  .  .  .  .  .  _A6rE1.  .  .  .  .  .  .  .  .  .  .  _A6.  .  .  .  .  .  .  .  .  _A6.  .  .  .  .  .  .  .  .  .  .  .  .  .  .  .  .  .  .  .  .  .  .  .  .  .  .  .  _A6.  .  .  .  _A6
_A6_A6_A6.  .  .  .  .  .  .  .  .  _AC.  .  .  .  .  .  .  .  .  .  .  .  .  _A6.  .  .  .  .  .  _A6.  .  .  .  .  .  .  .  .  .  .  .  .  .  .  .  .  .  .  .  .  .  .  .  .  .  .  .  .  .  .  .  .  .  .  .  .  .  _C9.  _A6.  .  .  .  .  .  .  .  .  .  _A1_A6_A6_A6_A6_A6_A6_A6_A6_A6_A6_A6_A6_A6.  .  .  .  _A6.  .  .  .  _A6
_A6_A6_A6~AC~AC~AC~AC~AC.  .  _A1_A6_A6_A6_A6_A6_A6_A6_A2bE2.  .  rE1.  .  bE2_A6.  .  _A6_A6_A6_A6_A6.  .  .  .  .  .  .  .  .  .  .  .  .  .  .  .  .  .  .  .  .  .  .  .  .  .  .  .  .  .  _RD.  _CD.  .  _A1_A6_A6_A6_A6_A6.  .  .  .  .  .  .  .  .  .  _A6.  .  .  .  .  bE3.  .  .  .  .  .  .  .  .  .  .  .  .  .  _CE.  _A6
_A6_A6_A6.  .  bPL.  .  .  .  .  .  .  .  .  .  .  .  _A6_A6_A2_CD.  .  _A1_A6_A6.  .  .  .  .  .  .  .  .  .  _A6.  .  _A6.  .  _A6.  .  bE2.  .  .  .  bE2.  .  .  .  .  .  .  .  .  .  .  .  .  .  .  .  .  _A6.  .  .  .  _A6rDArDArDArDArDArDArDArDArDArDA_A6.  yKE.  .  .  .  .  .  .  .  .  .  .  .  .  .  .  .  .  .  .  .  _A6
_A6_A6_A6.  .  .  .  .  .  .  _W0.  _AM.  _AM.  _AM.  _A6.  .  .  .  .  .  .  _A6.  .  .  .  .  .  .  .  rE5rE5.  rE5rE5.  rE5rE5.  rE5rE5_A6_AM_AM_AM_AM_A6.  .  .  .  .  .  .  .  .  .  .  rE1_A6.  .  .  .  _A6.  .  .  .  _A6rDArDArDArDArDArDArDArDArDArDA_A6.  .  .  _A6.  .  .  .  .  .  .  .  .  .  .  .  .  .  .  .  .  .  _A6
_A6_A6_A6_A6_A6_A6_A6_A6_A6_A6_A6_A6_A6_A6_A6_A6_A6_A6_A6.  .  .  .  .  .  .  _A6_A6_A6_A6_A6_A6_A6_A6_A6_A6_A6_A6_A6_A6_A6_A6_A6_A6_A6_A6_A6_A6_A6_A6_A6_A6_A6_A6_A6_A6_A6_A6_A6_A6_A6_A6_A6_A6_A6_A6_A6_A6_A6_A6.  .  .  .  _A6_A6_A6_A6_A6_A6_A6_A6_A6_A6_A6_A6_A6_A6_A6_A6_A6_A6_A6_A6_A6_A6_A6_A6_A6_A6_A6_A6_A6_A6_A6_A6_A6_A6_A6
_A6_A6_A6_A6_A6_A6_A6_A6_A6_A6_A6_A6_A6_A6_A6_A6_A6_A6_A6.  .  .  .  .  .  .  _A6_A6_A6_A6_A6_A6_A6_A6_A6_A6_A6_A6_A6_A6_A6_A6_A6_A6_A6_A6_A6_A6_A6_A6_A6_A6_A6_A6_A6_A6_A6_A6_A6_A6_A6_A6_A6_A6_A6_A6_A6_A6_A6_A6.  .  .  .  _A6_A6_A6_A6_A6_A6_A6_A6_A6_A6_A6_A6_A6_A6_A6_A6_A6_A6_A6_A6_A6_A6_A6_A6_A6_A6_A6_A6_A6_A6_A6_A6_A6_A6_A6

