<out> = Level(<level>,<game>,<raw>,autoscroll_speed=(-0.0, 0),name='Dungeons without Dragons',color=(0, 0, 0),postfx=[('ingame1.sfx', ())],vis_ofs=0,scroll=3,lower_offset=0.0,)
.  .  _A6_A6_A6_A6_A6_A6_A6_A6_A6_A6_A6_A6_A6_A6_A6_A6_A6_A6_A6_A6_A6_A6_A6_A6_A6_A6_A6_A6_A6_A6_A6_A6_A6_A6_A6_A6_A6_A6_A6_A6_A6_A6_A6_A6_A6_A6_A6_A6_A6_A6_A6_A6_A6_A6_A6_A6_A6_A6_A6_A6_A6_A6_A6_A6_A6_A6_A6_A6_A6_A6_A6_A6_A6_A6_A6_A6_A6_A6_A6_A6_A6_A6_A6_A6_A6_A6_A6_A6_A6_A6_A6_A6_A6_A6_A6_A6_A6_A6_A6_A6_A6_A6_A6_A6_A6_A6_A6
.  .  _A6pKE.  .  .  .  .  .  .  .  .  .  .  .  .  .  .  .  .  .  .  .  .  .  .  .  .  .  .  .  .  .  .  .  .  .  .  .  .  .  .  .  .  .  .  .  .  .  .  .  .  .  .  _A6rE1_S0_S0_S0_S0_S0_S0_S0_S0_S0_S0_S0_S0_A6.  .  bE0.  .  .  .  .  .  .  .  .  .  .  .  _A6.  .  .  .  .  .  .  .  .  .  .  .  .  .  .  .  .  .  .  .  .  .  _A6
.  .  _A6.  .  .  .  .  .  .  .  .  .  .  .  .  .  .  .  .  .  .  .  .  .  .  .  .  .  .  .  .  .  .  .  .  .  .  .  .  .  .  .  .  .  .  .  .  .  .  .  _A6rE1.  .  .  .  _S0_S0_S0_S0_S0_S0_S0_S0_S0_S0_S0_S0_A6.  .  .  .  .  .  .  .  .  .  .  .  .  .  .  .  _A6.  .  .  .  .  bE3.  .  .  .  .  .  .  .  .  .  .  .  .  .  .  _A6
.  .  _A6_A6_A6_A6_A6_A6_A6_A6_A6_A6_A6_A6_A6_A6rE1.  .  bE2bE2.  .  rE1_A6_A6_A6_A6_A6.  .  .  .  .  .  .  .  .  .  .  .  .  .  .  .  .  .  _A6rE1.  .  .  .  .  .  .  .  _S0_S0_S0_S0_S0_S0_S0_S0_S0_S0_S0_A6_A6.  .  rE1.  .  .  .  .  .  .  .  .  .  .  .  .  .  _A6.  .  .  .  .  .  .  .  .  .  .  .  .  .  .  .  .  .  .  .  _A6
.  .  _A6.  .  .  .  pDOyDOdDO.  .  .  .  .  .  _A6_A6_A6_A6_A6_A6_A6_A6.  .  .  .  _AC_A6bE2.  .  .  .  .  .  .  bE2.  .  .  .  .  .  .  .  .  .  .  .  .  .  .  .  .  .  _S0_S0_S0_S0_S0_S0_S0_S0_S0_S0_S0_S0_A6.  .  .  .  .  .  .  .  .  .  .  .  .  .  .  .  .  .  _A6.  _S5_S5.  .  .  .  .  .  .  .  .  .  _A6.  .  .  .  .  _A6
.  .  _A6.  .  .  .  .  .  .  .  .  .  .  .  .  .  .  .  .  .  .  .  .  .  .  .  .  .  _AC_A6.  .  .  rE1.  .  .  _A6.  .  .  .  .  .  .  .  .  .  .  .  .  .  _A6.  .  .  _A6_A6_A6_A6_A6_A6_A6_A6_A6_A6_A6_A6_A6.  .  bE0.  .  _D9.  .  .  .  .  .  .  .  .  .  .  .  .  _A6_A6_A6_A6_A6_A6_A6_A6_A6_A6_A5_A5_A5_A5_A5_A6.  .  .  _A6
.  .  _A6.  .  _A6_A6_A6_A6_A6_A6_A6.  .  .  .  .  .  .  .  .  .  .  .  .  .  .  .  .  .  _AC_A6_A6_A6_A6_A6_A6_A6_A6_A6_A6_A6_A6_A6.  .  .  .  .  .  .  .  .  .  .  .  .  .  .  .  .  .  .  .  .  .  .  .  .  .  .  .  _A6_A6_A6_A6_A6_A6_A6_A6_A6_A6_A6_A6_A6.  .  .  .  .  .  .  .  .  .  .  .  .  .  _H1.  .  .  .  .  .  .  .  _A6
.  .  _A6.  .  _A6.  .  .  .  .  _AC_A6.  .  .  .  .  .  .  .  .  .  .  .  .  .  .  .  .  .  .  .  .  .  .  .  .  .  .  .  .  .  .  .  .  .  .  .  .  .  .  .  .  .  .  .  .  .  .  .  .  .  .  .  .  .  .  .  .  .  .  _A6.  .  .  .  .  .  .  .  .  .  .  .  _A6.  .  .  .  .  .  .  .  .  .  .  .  .  .  .  .  .  .  .  .  .  .  _A6
.  .  _A6.  .  _A6.  .  .  .  .  .  _AC_A6.  .  .  .  .  .  .  .  .  .  .  .  .  .  .  .  .  .  .  .  .  .  .  .  .  .  .  .  .  .  .  .  .  _A6_A6_A6_A6_A6_A6_A6.  .  .  .  .  .  .  .  .  .  .  .  .  .  .  _CD.  .  _A6.  .  .  .  .  .  .  .  .  .  .  .  _AC_A6.  .  .  .  .  .  .  .  .  .  .  .  .  .  .  .  .  .  .  .  .  _A6
.  .  _A6.  .  _A6.  .  .  .  .  .  .  _AC_A6rE1.  .  bE2.  .  bE2.  .  bE2.  .  bE2.  .  .  _A6_A6_A6_A6_A6_A6_A6_A6_A6_A6_A6_A6_A6.  .  .  .  .  .  .  .  .  _AC_A6.  .  .  .  .  .  bE2.  .  bE2.  .  .  .  .  .  .  _A6.  .  .  .  .  .  .  .  .  .  .  .  .  _AC_A6_A6_AM_AM_AM_AM_AM_AM_A6.  .  .  .  .  .  .  .  .  .  .  .  _A6
.  .  _A6_FI.  _A6.  .  .  .  .  .  .  .  _AC_A6rDArDA_A6rDArDA_A6rDArDA_A6rDArDA_A6rDArDArDA_A6.  _AM.  _AM.  _AM.  _AM.  _AM.  _A6.  .  .  .  _AM_AM_AM_AM_AM.  _AC_A6bE0.  .  .  .  _A6.  .  _A6.  .  .  .  .  .  .  _A6.  .  .  .  .  .  .  .  .  .  .  .  .  .  _AC_A6_A6_A6_A6_A6_A6_A6_A6_A6_A6_A6_A6_A6_A6_A6_A6.  .  .  .  _A6
.  .  _A6.  .  _A6.  .  .  .  .  .  .  .  .  _AC_A6_A6_A6_A6_A6_A6_A6_A6_A6_A6_A6_A6_A6_A6_A6_A6.  .  .  .  .  .  .  .  .  .  .  _A6_A6_A6_A6_A6_A6_A6_A6_A6_A6_A6_A6.  _A6_A6_A6_A6_A6.  _A6_A6.  _A6_A6_A6_A6_A6_A6_A6_A6.  .  .  .  .  .  .  .  .  .  .  .  .  .  .  .  .  .  .  .  .  .  .  .  .  .  .  .  .  .  _A6.  .  .  .  _A6
.  .  _A6_A6_A6_A6.  .  .  .  .  .  .  .  .  .  .  .  _A6bE2.  .  rE1.  .  bE2_A6.  .  .  .  .  .  .  .  .  .  .  .  .  .  .  .  .  .  .  .  .  .  .  .  .  bE2.  .  rE2.  .  bE2.  .  rE2.  .  rE2.  .  .  .  .  .  .  .  .  .  .  .  .  .  .  .  .  .  .  .  .  .  .  .  .  .  .  .  .  .  .  .  .  .  .  .  .  .  _A6.  .  .  .  _A6
.  .  _A6.  .  .  .  .  .  .  .  .  .  .  .  .  .  .  .  .  .  .  .  .  .  .  .  _RD.  .  .  .  .  .  .  .  .  .  .  .  .  .  .  _SS.  .  .  .  .  .  .  .  .  .  .  .  .  .  .  .  .  .  .  .  .  .  .  .  .  .  .  .  .  .  .  .  .  .  .  .  .  .  .  .  .  .  .  .  _A6_A6_A6_A6_A6_A6_A6_A6.  .  .  .  .  .  .  _A6.  .  .  .  _A6
.  .  _A6.  .  .  .  .  .  .  .  .  .  .  .  .  .  .  .  .  .  .  .  .  .  .  .  .  .  .  .  .  .  .  .  .  .  .  .  .  .  .  .  .  .  .  .  .  .  .  .  .  .  bE2.  .  .  bE2.  bE2.  .  .  bE2.  .  .  .  .  .  .  .  .  .  .  .  .  .  .  .  .  .  .  .  .  .  .  .  _A6_AM_AM_AM_AM_AM_AM_A6.  .  .  .  _E6.  .  _A6.  .  .  .  _A6
.  .  _A6.  .  .  .  .  .  .  .  .  .  .  .  .  .  .  .  .  .  .  .  .  .  .  _A6_A6_A6_A6_A6_A6_A6_A6_A6_A6_A6_A6_A6_A6_A6_A6_A6_A6_A6_A6_A6_A6_A6_A6_A6_A6_A6_A6_A6_A6_A6_A6_A6_A6_A6_A6_A6_A6_A6.  .  .  .  _A6_A6_A6_A6_A6_A6_C8.  .  .  .  .  .  .  .  .  .  .  .  _RD.  .  .  .  .  .  .  .  .  .  .  .  .  .  _A6.  .  .  .  _A6
.  .  _A6.  .  .  .  .  .  .  .  .  .  .  .  .  .  .  .  .  .  .  .  .  .  .  _A6.  .  .  .  .  dKE_A6.  .  .  .  .  .  .  .  .  .  .  .  .  .  .  .  .  .  .  .  .  _A6rE1.  .  .  .  .  .  .  _A6.  .  .  .  .  .  .  .  .  _A6.  .  .  .  .  .  .  .  .  .  .  .  .  .  .  .  .  .  .  .  .  .  .  .  .  .  .  .  _A6.  .  .  .  _A6
.  .  _A6.  .  .  .  .  .  .  .  .  .  .  .  .  .  .  .  .  .  .  .  .  .  .  _A6.  .  .  .  .  .  _A6.  .  .  .  .  .  .  .  .  .  .  .  .  .  .  .  .  .  .  .  .  .  .  .  .  .  .  .  .  .  .  .  .  .  .  .  .  .  _C9.  _A6.  .  .  .  .  .  .  .  .  .  _A6_A6_A6_A6_A6_A6_A6_A6_A6_A6_A6_A6_A6_A6.  .  .  .  _A6.  .  .  .  _A6
.  .  _A6.  .  .  .  .  .  .  _A6_A6_A6_A6_A6_A6_A6_A6_A6bE2.  .  rE1.  .  bE2_A6.  .  _A6_A6_A6_A6_A6.  bE3.  .  .  .  .  .  .  .  .  .  .  .  .  .  .  .  .  .  .  .  .  .  .  .  .  .  .  .  .  .  _CD.  .  _A6_A6_A6_A6_A6_A6.  .  .  .  .  .  .  .  .  .  _A6.  .  .  .  .  bE3.  .  .  .  .  .  .  .  .  .  .  .  .  .  _CE.  _A6
.  .  _A6.  .  bPL.  .  .  .  .  .  .  .  .  .  .  .  _A6_A6_A6_CD.  .  _A6_A6_A6.  .  .  .  .  .  .  .  .  .  .  .  .  .  .  .  .  .  .  bE2.  .  .  .  bE2.  .  .  .  .  .  .  .  .  .  .  _RD.  .  .  .  .  _A6.  .  .  .  _A6rDArDArDArDArDArDArDArDArDArDA_A6.  yKE.  .  .  .  .  .  .  .  .  .  .  .  .  .  .  .  .  .  .  .  _A6
.  .  _A6.  .  .  .  .  .  .  _W0.  _AM.  _AM.  _AM.  _A6.  .  .  .  .  .  .  _A6.  .  .  .  .  .  .  .  .  .  .  .  .  .  .  .  .  .  .  _A6_AM_AM_AM_AM_A6.  .  .  .  .  .  .  .  .  rE1_A6.  .  .  .  .  .  _A6.  .  .  .  _A6rDArDArDArDArDArDArDArDArDArDA_A6.  .  .  _A6.  .  .  .  .  .  .  .  .  .  .  .  .  .  .  .  .  .  _A6
.  .  _A6_A6_A6_A6_A6_A6_A6_A6_A6_A6_A6_A6_A6_A6_A6_A6_A6.  .  .  .  .  .  .  _A6_A6_A6_A6_A6_A6_A6_A6_A6_A6_A6_A6_A6_A6_A6_A6_A6_A6_A6_A6_A6_A6_A6_A6_A6_A6_A6_A6_A6_A6_A6_A6_A6_A6_A6_A6_A6_A6_A6_A6_A6_A6_A6_A6.  .  .  .  _A6_A6_A6_A6_A6_A6_A6_A6_A6_A6_A6_A6_A6_A6_A6_A6_A6_A6_A6_A6_A6_A6_A6_A6_A6_A6_A6_A6_A6_A6_A6_A6_A6_A6_A6