<out> = Level(<level>,<game>,<raw>,autoscroll_speed=(-0.0, 0),name=_('Shoot em up'),color=(0, 0, 0),postfx=[('ingame1.sfx', ())],vis_ofs=0,scroll=3,lower_offset=0.0)
.  .  .  .  .  .  .  .  .  .  .  .  .  .  .  .  .  .  .  .  .  .  .  .  .  .  .  .  .  .  .  .  .  .  .  .  .  .  .  .  .  .  .  .  .  .  .  .  .  .  .  .  .  .  .  .  .  .  .  .  .  .  .  .  .  .  .  .  .  .  .  .  .  .  .  .  .  .  .  .  .  .  .  .  .  .  .  .  .  .  .  .  _EC.  .  .  .  .  .  .  _A9.  .  .  .  .  .  .  .  .  .  .  .  .  .  .  _A9_A9_A9_A9_A9_A9_A9_A9_A9_A9_A9
.  .  .  .  .  .  .  .  .  .  .  .  .  .  .  .  .  .  .  .  .  .  .  .  .  .  .  .  .  .  .  .  .  .  .  .  .  .  .  .  .  .  .  .  .  .  .  .  .  .  .  .  .  .  .  .  .  .  .  .  .  .  .  .  .  .  .  .  .  .  .  .  .  .  .  .  .  .  .  .  .  .  .  .  .  .  .  .  .  .  .  .  .  .  .  .  .  .  .  .  _A9.  .  .  .  .  .  .  .  .  .  .  .  .  .  .  .  .  .  .  .  .  .  .  .  .  .  .  .  .  .  .  .  .  .  .  .  .  .  .  .  .  .  .  .  .  .  .  rA9
.  .  .  .  .  .  .  .  .  .  .  .  .  .  .  .  .  .  .  .  .  .  .  .  .  .  .  .  .  .  .  .  .  .  .  .  .  .  .  .  .  .  .  .  .  .  .  .  .  .  .  .  .  .  .  .  .  .  .  .  .  .  .  .  .  .  .  .  .  .  .  .  .  .  .  .  .  .  .  .  .  .  .  .  .  .  .  .  .  .  .  .  .  .  .  .  .  .  .  .  _A9.  .  .  .  .  .  .  .  .  .  .  .  .  .  .  .  .  .  .  .  .  .  .  .  .  .  .  .  .  .  .  .  .  .  .  .  .  .  .  .  .  .  .  .  .  .  rA9rA9rA9
.  .  .  dPL.  .  .  .  .  .  .  .  .  .  .  .  .  .  .  .  .  .  .  .  .  .  .  .  .  .  .  .  .  .  .  .  .  .  .  .  .  .  .  .  .  .  .  .  .  .  .  .  .  .  .  .  .  .  .  .  .  .  .  .  .  .  .  .  .  .  .  .  .  .  .  .  _A9.  .  .  .  .  .  .  .  .  .  .  .  .  .  .  .  .  .  .  .  .  .  .  _A9.  .  .  .  .  .  .  .  .  .  .  .  .  .  .  .  .  .  .  .  .  .  .  .  .  .  .  .  .  .  .  .  .  .  .  .  .  .  .  .  .  .  .  .  .  rA9rA9rA9rA9rA9
.  .  .  .  .  .  .  .  .  .  .  .  .  .  .  .  .  .  .  .  .  .  .  .  .  .  .  .  .  .  .  .  .  .  .  .  .  .  .  .  .  .  .  .  .  .  .  .  .  .  .  .  .  .  .  .  .  .  .  .  .  .  .  .  .  .  .  .  .  .  .  .  .  .  .  .  _A9.  .  .  .  .  .  .  .  .  .  .  .  .  .  .  .  .  .  .  .  .  .  .  _A9.  .  .  .  .  .  .  .  .  .  .  .  .  .  .  .  .  .  .  .  .  .  .  .  .  .  .  .  .  .  .  .  .  .  .  .  .  .  .  .  .  .  .  .  rA9rA9rA9rA9rA9rA9rA9
.  .  .  _AM_AM.  .  .  .  .  .  .  .  .  .  .  .  .  .  .  .  .  .  .  .  .  .  .  .  .  .  .  .  .  .  .  .  .  .  .  .  .  .  .  .  .  .  .  .  .  .  .  .  .  .  .  .  .  .  .  .  .  .  .  .  .  .  .  .  .  .  .  .  .  .  .  _A9.  .  .  .  .  .  .  .  .  .  .  .  .  .  .  .  .  .  .  .  .  .  .  _A9.  .  .  .  .  .  .  .  .  .  .  .  .  .  .  .  .  .  .  .  .  .  .  .  .  .  .  .  .  .  .  .  .  .  .  .  .  yD9.  .  .  .  .  .  _A9_A9_A9.  _A9_A9_A9
.  .  .  _AM_AM.  .  .  .  .  .  .  .  .  .  .  .  .  .  .  .  .  .  .  .  .  .  .  .  .  _SM.  .  .  .  .  .  .  .  _E3.  .  .  .  .  .  .  .  .  .  .  .  .  .  .  .  .  .  .  dE1.  .  .  .  .  .  .  .  .  .  .  .  .  .  .  .  _A9.  .  .  .  .  .  .  .  .  .  .  .  .  .  .  .  .  .  .  .  .  .  .  _A9.  .  .  .  .  .  .  .  .  .  .  .  .  .  .  .  .  .  .  .  .  .  .  .  .  .  .  .  .  .  .  .  .  .  .  .  .  .  .  .  .  .  .  _FI_A9_A9_A9_A9_A9_A9_A9
.  .  _AM_W0.  _AM.  .  .  .  .  .  .  .  .  .  .  .  .  .  .  .  .  .  .  .  .  .  .  .  .  .  .  .  .  .  .  .  .  .  .  .  .  .  .  .  .  .  .  .  .  .  .  .  .  .  .  .  .  .  .  .  .  .  .  .  .  .  .  .  .  .  .  .  .  dRD.  .  .  .  .  .  .  .  .  .  .  .  .  .  .  .  .  .  .  .  .  .  .  .  _A9.  .  .  .  .  .  .  .  .  .  .  .  .  .  .  .  _E5.  .  .  .  .  .  _E5_E5.  .  .  .  .  .  .  .  .  .  .  .  .  .  .  .  .  .  .  _A9_A9_A9.  .  _A9_A9
.  .  _AM_AM_AM_AM.  .  .  .  .  .  .  .  .  .  .  .  .  .  .  .  .  .  .  .  .  .  .  .  .  .  _A9.  .  .  .  .  .  .  .  .  .  .  .  .  .  .  .  _A9dE2.  dE0.  .  dE2.  .  .  .  .  .  .  dE2.  .  .  _A9.  .  .  .  .  .  .  .  .  .  .  .  .  _A9_A9_A9_A9_A9.  .  .  .  .  .  .  _A9_A9_A9_A9_A9_A9_A9_A9.  .  .  _A9_A9_A9_A9_A9_A9_A9_A9_A9_A9_A9_A9_A9_A9_A9_A9_A9_A9_A9_A9_A9_A9_A9_A9_A9_A9_A9_A9_A9_A9_A9_A9_A9_A9_A9_A9_A9_A9_A9_A9_A9_A9_A9_A9_A9_A9_A9_A9
_A9_A9_A9_A9_A9_A9_A9_A9_A9_A9_A9_A9_A9_A9_A9_A9_A9_A9_A9_A9_A9_A9_A9_A9_A9_A9_A9_A9_A9_A9_A9_A9_A9_A9_A9_A9_A9_A9_A9_A9_A9_A9_A9_A9_A9_A9_A9_A9_A9_A9_A9_A9_A9_A9_A9_A9_A9_A9_A9_A9_A9_A9_A9_A9_A9_A9_A9_A9_A9_A9_A9_A9_A9_A9_A9_A9.  .  .  .  .  .  .  .  .  .  .  .  .  .  .  .  .  .  .  .  .  .  .  .  .  .  .  _A9.  .  .  .  .  .  .  .  .  .  .  .  .  .  .  .  .  .  .  .  .  .  .  .  .  .  .  .  .  .  .  .  .  .  .  .  .  .  .  _S5_A9_A9_A9_A9_A9_A9_A9_A9
.  .  .  .  .  .  .  .  .  .  .  .  .  .  .  .  .  .  .  .  .  .  .  .  .  .  .  .  .  .  .  .  .  .  .  .  .  .  .  .  .  .  .  .  .  .  .  .  .  .  .  .  .  .  .  .  .  .  .  .  .  .  .  .  .  .  .  .  .  .  .  .  .  .  .  .  .  .  .  .  .  .  .  .  .  .  .  .  .  .  .  .  .  .  .  .  .  .  .  .  .  .  .  _I0.  .  .  .  .  .  .  .  .  .  .  .  .  .  .  dE0.  .  dE0.  dE0.  .  dE0.  .  dE0.  dE0.  .  dE0.  .  dE0.  dE0.  .  _S4_A9_A9_A9_A9_A9_A9_A9_A9
.  .  .  .  .  .  .  .  .  .  .  .  .  .  .  .  .  .  .  .  .  .  .  .  .  .  .  .  .  .  .  .  .  .  .  .  .  .  .  .  .  .  .  .  .  .  .  .  .  .  .  .  .  .  .  .  .  .  .  .  .  .  .  .  .  .  .  .  .  .  .  .  .  .  .  _I0.  dE0.  .  .  .  .  .  .  .  .  .  .  dE0.  .  .  dE0.  .  .  .  .  .  .  .  .  _I0.  .  .  .  .  .  .  .  .  .  .  .  .  .  .  .  .  dE0.  .  dE0.  dE0.  .  dE0.  .  dE0.  dE0.  .  dE0.  .  dE0.  dE0_S4_A9_A9_A9_A9.  .  _A9_A9
.  .  .  .  .  .  .  .  .  .  .  .  .  .  .  .  .  .  .  .  .  .  .  .  .  .  .  .  .  .  .  .  .  .  .  .  .  .  .  .  .  .  .  .  .  .  .  .  .  .  .  .  .  .  .  .  .  .  .  .  .  .  .  .  .  .  .  .  .  .  .  .  .  .  .  .  _A9_A9_A9_A9_A9_A9_A9_A9_A9_A9_A9_A9_A9_A9_A9_A9_A9_A9_A9_A9_A9_A9_A9_A9_A9_A9_A9_A9_A9_A9_A9_A9_A9_A9_A9_A9_A9_A9_A9_A9_A9_A9_A9_A9_A9_A9_A9_A9_A9_A9_A9_A9_A9_A9_A9_A9_A9_A9_A9_A9_A9_A9_A9_A9_A9_A9_A9_A9_A9_A9_A9_A9.  .  _A9_A9