<out> = Level(<level>,<game>,<raw>,autoscroll_speed=(-0.0, -0.0),name=_('Bonus II'),color=(0, 0, 0),postfx=[('ingame1.sfx', ())],vis_ofs=100,bgimg=18,scroll=3,lower_offset=0.0)




































































































_A5_A5_A5_A5_A5_A5_A5_A5_A5_A5_A5_A5_A5_A5_A5_A5_A5_A5_A5_A5_A5_A5_A5_A5_A5_A5_A5_A5_A5_A5_A5_A5_A5_A5_A5_A5_A5_A5_A5_A5_A5_A5_A5_A5_A5_A5_A5_A5_A5_A5_A5_A5_A5_A5_A5_A5_A5_A5_A5_A5_A5_A5_A5_A5_A5_A5_A5_A5_A5_A5_A5
_A5_A5_A5_A5_A5_A5_A5.  .  .  .  .  .  .  .  .  .  .  .  .  .  .  .  .  .  .  .  .  .  .  .  .  .  .  .  .  .  .  .  .  .  .  .  .  .  .  _A5rDA.  yS5.  yS2yS2yS2.  .  yS2yS2yS2.  .  .  .  .  .  .  .  .  .  .  _A5
_A5_A5_A5_A5_A5_A5_A5.  .  .  .  .  .  .  .  .  .  .  .  .  .  .  .  .  .  .  .  .  .  .  .  .  .  .  .  .  .  .  .  .  .  .  .  .  .  .  _A5.  .  yS5.  .  yS2.  .  .  .  .  .  .  .  .  .  .  .  .  .  .  .  .  _A5
_A5_A5_A5_A5_A5_A5_A5.  .  .  .  .  .  .  .  .  .  .  .  .  .  .  .  .  .  .  .  yS2.  yS2.  .  .  .  .  .  .  .  .  .  .  .  .  .  .  .  _A5.  .  .  .  .  .  .  .  .  .  rE2.  .  .  .  .  .  .  .  .  .  .  .  _A5
_A5_A5_A5_A5_A5_A5_A5.  .  .  .  .  .  .  .  .  .  .  .  .  .  .  .  .  .  .  .  .  .  .  .  .  .  .  .  .  .  .  .  .  .  .  .  .  .  .  _A5rI0.  .  .  .  .  rE1.  .  .  _A9.  .  .  .  .  rE1.  .  .  .  .  rI0_A5
_A5_A5_A5_A5_A5_A5_A5.  .  .  .  yS2yS2.  .  .  .  .  .  .  .  .  _A9.  _A9_A9.  _A9_A9_A9.  _A9_A9_A9.  _A9_A9.  .  .  .  .  .  .  .  .  _AC_AC_AC_AC_AC_AC_AC_AC_AC_AC_AC_AC_AC_AC_AC_AC_AC_AC_AC_AC_AC_AC_AC_AC_A5
_A5_A5_A5_A5_A5_A5_A5.  .  .  .  yS2yS2.  bKE.  .  .  .  .  .  .  .  .  .  .  .  .  .  .  .  .  .  .  .  .  .  .  .  .  .  .  .  .  .  .  .  .  .  .  .  .  .  .  .  .  .  .  .  .  .  .  .  .  .  .  .  .  .  _AC_A5
_A5_A5_A5_A5_A5_A5_A5.  .  .  .  yS2yS2.  .  .  .  .  .  .  .  .  .  rED.  .  rED.  .  .  rED.  .  .  rED.  .  .  _A9.  .  .  .  rI0.  .  rI0.  .  rI0.  .  .  .  .  .  .  .  .  .  .  .  .  .  .  .  .  .  .  _AC_A5
_A5_A5_A5_A5_A5_A5_A5.  .  .  .  _A9_A9_A9_A9_A9_A9_A9.  .  .  .  .  .  .  .  .  .  .  .  .  .  .  .  .  .  .  .  .  .  .  .  .  .  .  .  .  .  .  .  .  .  .  .  .  .  .  .  .  .  .  .  .  .  .  .  .  .  .  _AC_A5
_A5_A5_A5_A5_A5_A5_A5.  .  .  .  .  .  .  .  .  .  .  .  .  .  .  .  .  .  .  .  .  .  .  .  .  .  .  .  .  .  .  .  .  _A9.  .  .  .  .  .  .  .  .  .  .  .  gW0.  gAM.  gAM.  gAM.  .  .  .  .  .  .  rE4.  _AC_A5
_A5_A5_A5_A5_A5_A5_A5.  .  .  .  .  .  .  .  .  .  .  yKE.  .  .  .  .  .  .  .  .  .  rI0.  .  .  rI0.  .  .  rI0.  .  .  .  .  _E2.  .  _E2.  .  _E2.  .  .  .  .  .  .  .  .  .  .  .  .  .  .  .  .  .  .  .  _A5
_A5_A5_A5_A5_A5_A5_A5.  .  .  .  .  .  .  .  .  .  .  .  .  .  .  .  .  .  .  .  .  .  .  .  .  .  .  .  .  .  .  .  .  .  .  .  _AB.  .  _AB.  .  _AB.  .  _A9_A9_A9_A9_A9_A9_A9_A9_A9.  .  _A9_A9_A9_A9.  .  .  _A5
_A5_A5_A5_A5_A5_A5_A5.  .  .  .  .  .  .  .  .  .  .  .  .  .  .  .  .  .  .  .  .  .  .  .  .  .  .  .  .  .  .  .  .  .  .  .  .  .  .  .  .  .  .  .  .  .  .  .  .  .  .  .  .  .  .  .  _A9.  .  .  .  .  .  _A5
_A5_A5_A5_A5_A5_A5_A5.  .  .  .  .  .  .  .  .  .  .  .  .  .  .  .  .  .  .  .  .  .  .  .  .  .  .  .  .  .  .  .  .  .  .  .  .  .  .  .  .  .  .  .  .  .  .  .  .  .  .  .  .  .  .  .  _A9.  _A9_A9_A9_A9_A9_A5
_A5_A5_A5_A5_A5_A5_A5.  .  .  .  .  .  .  .  .  .  .  .  .  .  .  .  .  .  .  .  .  .  .  .  .  .  .  .  .  .  .  .  .  .  .  .  .  .  .  .  .  .  .  .  .  .  .  .  .  pSM.  .  .  .  .  .  .  .  yS0yS0yS0yS0yS0_A5
_A5_A5_A5_A5_A5_A5_A5.  .  .  .  .  _AC_A5_AC_AC_A5_A5_A5_A5_A5_A5_A5_A5_A5_A5.  .  _A8rE2_A8.  _A8rE2_A8.  _A8rE2_A8.  .  yS0.  .  yS0.  .  yS0.  .  yS0.  .  .  .  .  .  .  .  .  _A9_A9_A9_A9_A9_A9_A9_A9_A9_A9_A5
_A5_A5_A5_A5_A5_A5_A5.  _PL.  .  .  _AC_A5.  .  _A5yS0yS0yS0.  .  .  .  .  .  .  .  .  _A8.  .  .  _A8.  .  .  _A8.  .  .  _A9.  .  _A9.  .  _A9.  .  _A9.  _A9_A9_A9_A9_A9_A9_A9_A9_A9.  .  .  .  .  .  .  .  .  _A5
_A5_A5_A5_A5_A5_A5_A5.  .  .  .  .  _ACbDO.  pFI_A5yS0yS0.  .  .  .  .  .  .  .  .  .  .  .  .  .  .  .  .  .  .  .  .  .  .  .  .  .  .  .  .  .  .  .  .  .  .  .  .  .  .  .  .  .  .  .  .  .  .  .  .  .  .  _A5
_A5_A5_A5_A5_A5_A5_A5.  .  .  .  .  .  .  .  .  _A5yS0.  .  .  .  rE1.  .  rI0.  .  .  .  .  rMI.  .  .  rMI.  .  .  .  .  .  .  rED.  .  rED.  .  rED.  .  .  .  .  .  .  .  .  .  .  .  .  .  .  .  .  .  .  .  _A5
_A5_A5_A5_A5_A5_A5_A5_A5_A5_A5_A5_A5_A5_A5_A5_A5_A5_A5_A5_A5_A5_A5_A5_A5_A5_A5_A5_A5_A5_A5_A5_A5_A5_A5_A5_A5_A5_A5_A5_A5_A5_A5_A5_A5_A5_A5_A5_A5_A5_A5_A5_A5_A5_A5_A5_A5_A5_A5_A5_A5_A5_A5_A5_A5_A5_A5_A5_A5_A5_A5_A5



































































































