<out> = Level(<level>,<game>,<raw>,autoscroll_speed=(-0.0, 0),name=_('The Maze'),color=(10, 0, 0),postfx=[('ingame1.sfx', ())],vis_ofs=0,scroll=3,lower_offset=0.0)


.  .  .  .  .  .  .  _A0_A0_A0_A0_A0_A0_A0_A0_A0_A0_A0_A0_A0_A0_A0_A0_A0_A0_A0
.  .  .  .  .  .  .  _A0dTB_PL.  .  .  .  .  .  .  .  .  .  .  .  .  .  .  _A0.  .  .  .  .  .  .  .  .  .  .  .  .  .  .  .  .  .  .  .  .  .  .  .  .  .  .  .  .  .  .  .  .  .  .  .  .  .  .  .  .  .  _A0_A0_A0_A0_A0_A0_A0_A0_A0_A0_A0_A0_A0_A0_A0_A0_A0_A0_A0.  .  .  .  .  .  .  .  .  .  .  .  .  .  .  .  .  .  .  .  .  .  .  .  .  .  .  .  .  .  .  .  .  .  .  .  .  .  .  .  .  .  .  .  .  .  .  .  .  .  .  .  .  .  .  .  .  .  .  .  .  .  .  .  .  .  .  .  .  .  .  .  .  .  .  .  .  .  .  .  .  .  .  .  .  .  .  .  .  .  .  .  .  .  .  .  .  .  .  .  .  .  .  .  .  .  .  _A0_A0_A0
.  .  .  .  .  .  .  _A0.  .  .  .  .  .  .  .  .  .  .  .  .  .  .  .  .  _A0.  .  .  .  .  .  .  .  .  .  .  .  .  .  .  .  .  .  .  .  .  .  .  .  .  .  .  .  .  .  .  .  .  .  .  .  .  .  .  .  .  .  _A0PTB.  .  .  .  .  .  .  .  .  .  .  .  .  .  .  .  _A0.  .  .  .  .  .  .  .  .  .  .  .  .  .  .  .  .  .  .  .  .  .  .  .  .  .  .  .  .  .  .  .  .  .  .  .  _A0_A0_A0_A0_A0_A0_A0_A0_A0_A0_A0_A0_A0_A0_A0_A0_A0_A0_A0
.  .  .  .  .  .  .  _A0_A0_A0_A0_A0_A0_A0.  _A0_A0_A0_A0_A0_A0_A0_A0_A0_A0_A0.  .  .  .  .  .  .  .  .  .  .  .  .  .  .  .  .  .  .  .  .  .  .  .  .  .  .  .  .  .  .  .  .  .  .  .  .  .  .  .  .  .  _A0.  .  .  .  .  .  .  .  .  .  .  .  .  .  .  .  .  _A0.  .  .  .  .  .  .  .  .  .  .  .  .  .  .  .  .  .  .  .  .  .  .  .  .  .  .  .  .  .  .  .  .  .  .  .  _A0bTB.  .  .  .  .  .  .  .  .  .  .  .  .  .  .  .  _A0
.  .  .  .  .  .  .  _A0PTA.  .  .  .  .  .  .  iA0iTB.  .  .  .  .  .  _FI_A0.  .  .  .  .  .  .  .  .  .  .  .  .  .  .  .  .  .  .  .  .  .  .  .  .  .  .  .  .  .  .  .  .  .  .  .  .  .  .  .  .  .  _A0_A0_A0_A0_A0_A0_A0.  _A0_A0_A0_A0_A0_A0_A0_A0_A0_A0_A0.  .  .  .  .  .  .  .  .  .  .  .  .  .  .  .  .  .  .  .  .  .  .  .  .  .  .  .  .  .  .  .  .  .  .  .  _A0.  .  .  .  .  .  .  .  .  .  .  .  .  .  .  .  .  _A0
.  .  .  .  .  .  .  _A0.  .  .  .  .  .  .  .  iA0.  .  .  .  .  .  .  .  _A0.  .  .  .  .  .  .  .  .  .  .  .  .  .  .  .  .  .  .  .  .  .  .  .  .  .  .  .  .  .  .  .  .  .  .  .  .  .  .  .  .  .  _A0bTA.  .  .  .  .  .  .  iA0.  .  .  .  .  .  .  _FI_A0.  .  .  .  .  .  .  .  .  .  .  .  .  .  .  .  .  .  .  .  .  .  .  .  .  .  .  .  .  .  .  .  .  .  .  .  _A0_A0_A0_A0_A0_A0_A0.  _A0_A0_A0_A0_A0_A0_A0_A0_A0_A0_A0
.  .  .  .  .  .  .  _A0_A0_A0.  _A0_A0_A0_A0_A0_A0_A0_A0_A0_A0_A0_A0_A0_A0_A0.  .  .  .  .  .  .  .  .  .  .  .  .  .  .  .  .  .  .  .  .  .  .  .  .  .  .  .  .  .  .  .  .  .  .  .  .  .  .  .  .  .  _A0.  .  .  .  .  .  .  .  iA0.  .  .  .  .  .  .  .  _A0.  .  .  .  .  .  .  .  .  .  .  .  .  .  .  .  .  .  .  .  .  .  .  .  .  .  .  .  .  .  .  .  .  .  .  .  _A0dTA.  .  .  .  .  .  .  iA0.  .  .  .  .  .  .  _FI_A0
.  .  .  .  .  .  .  _A0.  .  .  .  .  .  .  .  .  .  .  .  .  .  .  .  .  _A0.  .  .  .  .  .  .  .  .  .  .  .  .  .  .  .  .  .  .  .  .  .  .  .  .  .  .  .  .  .  .  .  .  .  .  .  .  .  .  .  .  .  _A0_A0_A0.  _A0_A0_A0_A0_A0_A0_A0_A0_A0_A0_A0_A0_A0_A0_A0.  .  .  .  .  .  .  .  .  .  .  .  .  .  .  .  .  .  .  .  .  .  .  .  .  .  .  .  .  .  .  .  .  .  .  .  _A0.  .  .  .  .  .  .  .  iA0.  .  .  .  .  .  .  .  _A0
.  .  .  .  .  .  .  _A0.  .  .  .  .  .  .  .  .  .  .  .  .  .  .  .  .  _A0.  .  .  .  .  .  .  .  .  .  .  .  .  .  .  .  .  .  .  .  .  .  .  .  .  .  .  .  .  .  .  .  .  .  .  .  .  .  .  .  .  .  _A0.  .  .  .  .  .  .  .  .  .  .  .  .  .  .  .  iS5_A0.  .  .  .  .  .  .  .  .  .  .  .  .  .  .  .  .  .  .  .  .  .  .  .  .  .  .  .  .  .  .  .  .  .  .  .  _A0_A0_A0.  _A0_A0_A0_A0_A0_A0_A0_A0_A0_A0_A0_A0_A0_A0_A0
.  .  .  .  .  .  .  _A0_A0_A0_A0_A0_A0_A0_A0_A0_A0_A0_A0_A0_A0_A0_A0_A0_A0_A0.  .  .  .  .  .  .  .  .  .  .  .  .  .  .  .  .  .  .  .  .  .  .  .  .  .  .  .  .  .  .  .  .  .  .  .  .  .  .  .  .  .  _A0.  .  .  .  .  .  .  .  .  .  .  .  .  .  .  .  .  _A0.  .  .  .  .  .  .  .  .  .  .  .  .  .  .  .  .  .  .  .  .  .  .  .  .  .  .  .  .  .  .  .  .  .  .  .  _A0.  .  .  .  .  .  .  .  .  .  .  .  .  .  .  iTAiS5_A0
.  .  .  .  .  .  .  .  .  .  .  .  .  .  .  .  .  .  .  .  .  .  .  .  .  .  .  .  .  .  .  .  .  .  .  .  .  .  .  .  .  .  .  .  .  .  .  .  .  .  .  .  .  .  .  .  .  .  .  .  .  .  .  .  .  .  .  .  _A0_A0_A0_A0_A0_A0_A0_A0_A0_A0_A0_A0_A0_A0_A0_A0_A0_A0_A0.  .  .  .  .  .  .  .  .  .  .  .  .  .  .  .  .  .  .  .  .  .  .  .  .  .  .  .  .  .  .  .  .  .  .  .  _A0.  .  .  .  .  .  .  .  .  .  .  .  .  .  .  .  .  _A0
.  .  .  .  .  .  .  .  .  .  .  .  .  .  .  .  .  .  .  .  .  .  .  .  .  .  .  .  .  .  .  .  .  .  .  .  .  .  .  .  .  .  .  .  .  .  .  .  .  .  .  .  .  .  .  .  .  .  .  .  .  .  .  .  .  .  .  .  .  .  .  .  .  .  .  .  .  .  .  .  .  .  .  .  .  .  .  .  .  .  .  .  .  .  .  .  .  .  .  .  .  .  .  .  .  .  .  .  .  .  .  .  .  .  .  .  .  .  .  .  .  .  .  _A0_A0_A0_A0_A0_A0_A0_A0_A0_A0_A0_A0_A0_A0_A0_A0_A0_A0_A0