<out> = Level(<level>,<game>,<raw>,autoscroll_speed=(0.2, 0),name=_('The Maze'),color=(10, 0, 0),postfx=[('ingame1.sfx', ())],vis_ofs=0,scroll=2,lower_offset=0.0)


.  .  .  .  .  .  .  _A0_A0_A0_A0_A0_A0_A0_A0_A0_A0_A0_A0_A0_A0_A0_A0_A0_A0_A0
.  .  .  .  .  .  .  _A0dTB_PL.  .  .  .  .  .  .  .  .  .  .  .  .  .  .  _A0.  .  .  .  .  .  .  .  .  .  .  .  .  .  .  .  .  .  .  .  .  .  .  .  .  .  .  .  .  .  .  .  .  .  .  .  .  .  .  .  .  .  _A0_A0_A0_A0_A0_A0_A0_A0_A0_A0_A0_A0_A0_A0_A0_A0_A0_A0_A0
.  .  .  .  .  .  .  _A0.  .  .  .  .  .  .  .  .  .  .  .  .  .  .  .  .  _A0.  .  .  .  .  .  .  .  .  .  .  .  .  .  .  .  .  .  .  .  .  .  .  .  .  .  .  .  .  .  .  .  .  .  .  .  .  .  .  .  .  .  _A0PTB.  .  .  .  .  .  .  .  .  .  .  .  .  .  .  .  _A0.  .  .  .  .  .  .  .  .  .  .  .  .  .  .  .  .  .  .  .  .  .  .  .  .  .  .  .  .  .  .  .  .  .  .  .  .  .  .  .  .  .  .  .  .  .  .  .  .  .  .  .  _A0_A0_A0
.  .  .  .  .  .  .  _A0_A0_A0_A0_A0_A0_A0.  _A0_A0_A0_A0_A0_A0_A0_A0_A0_A0_A0.  .  .  .  .  .  .  .  .  .  .  .  .  .  .  .  .  .  .  .  .  .  .  .  .  .  .  .  .  .  .  .  .  .  .  .  .  .  .  .  .  .  _A0.  .  .  .  .  .  .  .  .  .  .  .  .  .  .  .  .  _A0
.  .  .  .  .  .  .  _A0PTA.  .  .  .  .  .  .  iA0iTB.  .  .  .  .  .  _FI_A0.  .  .  .  .  .  .  .  .  .  .  .  .  .  .  .  .  .  .  .  .  .  .  .  .  .  .  .  .  .  .  .  .  .  .  .  .  .  .  .  .  .  _A0_A0_A0_A0_A0_A0_A0.  _A0_A0_A0_A0_A0_A0_A0_A0_A0_A0_A0
.  .  .  .  .  .  .  _A0.  .  .  .  .  .  .  .  iA0.  .  .  .  .  .  .  .  _A0.  .  .  .  .  .  .  .  .  .  .  .  .  .  .  .  .  .  .  .  .  .  .  .  .  .  .  .  .  .  .  .  .  .  .  .  .  .  .  .  .  .  _A0dTA.  .  .  .  .  .  .  iA0.  .  .  .  .  .  .  _FI_A0
.  .  .  .  .  .  .  _A0_A0_A0.  _A0_A0_A0_A0_A0_A0_A0_A0_A0_A0_A0_A0_A0_A0_A0.  .  .  .  .  .  .  .  .  .  .  .  .  .  .  .  .  .  .  .  .  .  .  .  .  .  .  .  .  .  .  .  .  .  .  .  .  .  .  .  .  .  _A0.  .  .  .  .  .  .  .  iA0.  .  .  .  .  .  .  .  _A0
.  .  .  .  .  .  .  _A0.  .  .  .  .  .  .  .  .  .  .  .  .  .  .  .  iTA_A0.  .  .  .  .  .  .  .  .  .  .  .  .  .  .  .  .  .  .  .  .  .  .  .  .  .  .  .  .  .  .  .  .  .  .  .  .  .  .  .  .  .  _A0_A0_A0.  _A0_A0_A0_A0_A0_A0_A0_A0_A0_A0_A0_A0_A0_A0_A0
.  .  .  .  .  .  .  _A0.  .  .  .  .  .  .  .  .  .  .  .  .  .  .  .  .  _A0.  .  .  .  .  .  .  .  .  .  .  .  .  .  .  .  .  .  .  .  .  .  .  .  .  .  .  .  .  .  .  .  .  .  .  .  .  .  .  .  .  .  _A0.  .  .  .  .  .  .  .  .  .  .  .  .  .  .  .  iS5_A0
.  .  .  .  .  .  .  _A0_A0_A0_A0_A0_A0_A0_A0_A0_A0_A0_A0_A0_A0_A0_A0_A0_A0_A0.  .  .  .  .  .  .  .  .  .  .  .  .  .  .  .  .  .  .  .  .  .  .  .  .  .  .  .  .  .  .  .  .  .  .  .  .  .  .  .  .  .  _A0.  .  .  .  .  .  .  .  .  .  .  .  .  .  .  .  .  _A0
.  .  .  .  .  .  .  .  .  .  .  .  .  .  .  .  .  .  .  .  .  .  .  .  .  .  .  .  .  .  .  .  .  .  .  .  .  .  .  .  .  .  .  .  .  .  .  .  .  .  .  .  .  .  .  .  .  .  .  .  .  .  .  .  .  .  .  .  _A0_A0_A0_A0_A0_A0_A0_A0_A0_A0_A0_A0_A0_A0_A0_A0_A0_A0_A0